









  !
 AAA
                                   AAA
                                     B
   O    *   O   *   O   *    AAA     B      B 
                                     B      B
                                     B      B
                            AAAAAAAAAAAAAAAAA
                           ABBBBBBBBBBBBBBBBB
     ^      ^      ^      ABBBBBBBBBBBBBBBBBB
AAAAAA^^!!^^AA^!!^AAAAAAAABBBBBBBBBBBBBBBBBBB
BBBBBBBBBBBBBBBBBBBBBBBBBBBBBBBBBBBBBBBBBBBBB
