





     *
                   *                  i
* 

                               *
               
AAAAAAAAAAAAAA     ^^^^^       AAAAAAAAAAAAAA
BBBBBBBBBBBBBBAO   AAAAA     OABBBBBBBBBBBBBB
BBBBBBBBBBBBBBB O           OABBBBBBBBBBBBBBB
BBBBBBBBBBBBBBB AO   *      ABBBBBBBBBBBBBBBB
BBBBBB          BAAAAA OOO ABBBBBBBBBBBBBBBBB
BBBBBB          BBBBBBAAAAABBBBBBBBBBBBBBBBBB
BBBBBBOOOOOOOBBBBBBBBBBBBBBBBBBBBBBBBBBBBBBBB
BBBBBBBBBBBBBBBBBBBBBBBBBBBBBBBBBBBBBBBBBBBBB
BBBBBBBBBBBBBBBBBBBBBBBBBBBBBBBBBBBBBBBBBBBBB
BBBBBBBBBBBBBBBBBBBBBBBBBBBBBBBBBBBBBBBBBBBBB
